#######
#A    #
# ### #
#   # #
### # #
#     B#
#######